++++++++++++++++
++      +++    +
+    +    + ++++
+++  + ++ + + ++
+++  ++++      +
+         +++  +
++++++  +      +
++        +++  +
++  + +++  + + +
++  + +    +   +
++++++++++++++++